8
110
1	0	0	0	0	0	0	0	0	0	0	0	0	0	0	0	0	0	0	0	0	0	0	0	0	0	0	0	0	0	0	0	0	0	0	0	0	0	0	0	0	0	0	0	0	0	0	0	0	0	0	0	0	0	0	0	0	0	0	0	0	0	0	0	0	0	0	0	0	0	0	0	0	0	0	0	0	0	0	0	0	4	6	0	0	0	0	0	0	0	0	0	0	0	0	0	0	0	0	0	0	0	0	0	0	0	0	0	0	1
1	0	0	0	0	0	0	0	0	0	0	0	0	0	0	0	0	0	0	0	0	0	0	0	0	0	0	0	0	0	0	0	0	0	0	0	0	0	0	0	0	0	0	0	0	0	0	0	0	0	0	0	0	0	0	0	0	0	0	0	0	0	0	0	0	0	0	0	0	0	0	0	0	0	0	0	0	0	0	0	0	4	6	0	0	0	0	0	0	0	0	0	0	0	0	0	0	0	0	0	0	27	0	0	0	0	0	0	0	1
1	22	0	0	0	0	0	0	0	0	0	0	0	0	0	0	0	0	0	0	0	0	0	26	26	26	0	0	0	0	0	0	0	0	0	0	0	0	0	0	0	20	20	0	0	0	0	0	0	0	0	0	0	0	0	0	0	0	0	0	0	0	0	0	0	0	0	0	0	0	0	0	0	0	0	0	0	0	0	0	0	4	6	0	0	0	0	0	0	0	0	0	0	0	0	0	0	0	0	0	0	0	0	0	0	0	0	0	0	1
1	15	16	0	0	0	0	0	0	0	0	0	0	0	0	0	0	0	0	0	0	26	26	1	2	3	26	26	0	0	0	0	0	0	0	0	0	0	0	0	1	2	2	3	0	0	0	0	0	0	0	0	0	0	0	0	0	0	0	0	0	0	0	0	0	0	0	0	17	0	0	0	0	0	0	0	0	0	0	0	0	4	6	0	0	0	0	17	0	0	0	0	17	0	0	20	0	0	0	0	0	0	0	17	0	0	0	0	0	1
1	0	0	0	0	21	19	0	0	0	0	17	0	0	0	0	0	0	0	0	0	1	7	8	5	10	11	3	0	0	0	0	0	0	0	0	0	0	1	7	8	5	5	6	0	0	0	0	0	0	0	0	0	0	0	0	0	0	0	20	22	0	0	0	18	0	0	0	1	3	0	21	22	0	17	0	0	0	0	0	0	4	10	11	3	0	0	17	0	0	0	14	15	15	15	15	15	15	15	15	15	15	15	15	16	0	0	0	0	1
1	0	0	0	0	14	15	16	0	0	0	17	0	0	0	0	0	0	0	0	0	12	9	9	9	9	9	13	0	0	0	0	0	0	0	0	1	7	8	5	9	9	9	13	0	0	0	0	0	0	0	0	0	25	23	0	0	0	14	15	16	0	0	0	0	0	0	0	4	10	11	2	2	2	3	0	0	0	0	0	0	12	9	9	13	0	0	17	0	0	0	0	0	0	0	0	0	0	0	0	0	0	0	0	0	0	0	0	0	1
1	24	23	28	0	0	0	0	0	0	0	17	26	28	0	0	0	0	0	17	0	0	0	0	0	0	0	0	0	0	0	0	0	0	1	7	8	5	5	6	0	0	0	0	0	0	0	0	0	0	0	0	14	15	16	0	0	0	0	0	0	0	0	0	0	0	0	0	12	9	9	9	9	9	13	0	0	0	0	0	0	0	0	0	0	0	17	17	0	24	21	0	0	25	29	26	0	0	0	19	0	0	0	0	0	0	0	22	30	1
2	2	2	2	2	2	2	2	2	2	2	2	2	2	3	0	0	0	1	2	2	2	2	2	2	2	2	2	2	2	2	2	2	7	8	5	5	5	5	10	11	2	2	2	3	0	0	0	18	0	0	0	0	0	0	0	0	0	0	0	0	0	0	0	0	0	0	0	0	0	0	0	0	0	0	0	0	0	0	1	2	2	2	2	2	2	2	2	2	2	2	2	2	2	2	2	2	2	2	2	2	2	2	2	2	2	2	2	2	1